11111111111111
1P000000000001
11000000000001
10000010000001
1000001C100001
10000001000001
10000000000011
100000000000E1
11111111111111
