111111111111111
110111111111111
111111111111111
111111111111111
100000000000CE1
100000000000011
1CCCCCCCCCCCCC1
1CCCCCCCCCCCCC1
1CCCCCCCCCCCCC1
1CCCCCCCCCCCCC1
1PCCCCCCCCCCCC1
111111111111111
