111111111111111
111111111111111
111111111111111
111111111111111
1000000000000E1
100000000000001
1CCCCCCCCCCCCC1
1CCCCCCCCCCCCC1
1CCCCCCCCCCCCC1
1CCCCCCCCCCCCC1
1PCCCCCCCCCCCC1
111111111111111
