11111111111111111111111111111111
10000CCC000000000000000000000001
10100000000000000000000000000001
10100000000000000000000000000001
10100000000000000000000000000001
10100000000000000000000000000001
10100000000000000000000000000001
10100000000000000000000000000001
10100000000000000000000000000001
1PE00000000000000000000000000001
11111111111111111111111111111111
