11111111111111111111
111111111000110001C1
11111000101011010101
10101000101011010101
110E101010101C010101
11011010101001010101
11000010101100010101
11110010101111110101
11111110101111110101
11111110100000110101
10000010111110110101
10000010P00000110001
11111111111111111111
