1C111111111
1E000000001
10000000001
10000000001
1000C000001
10000000001
1P000000001
11111111111
