11111111111
1E005000001
10000000001
10000000001
10000000001
10000000001
1P000000001
11111111111
