11111
100P1
1CC01
1CC01
1E001
11111
