111111
100001
100001
100001
100001
1CCEP1
111111
111111
