111111
10C0E1
111011
111011
110011
1P0111
111111
